10001
00000
00200
00000
-
111111111111111
100000000000001
100000000000001
100000000000001
100000000000001
100000000000001
100000000000001
100000200000001
100000000000001
100000000000001
100000000000001
100000000000001
100000000000001
100000000000001
111111111111111
-
000000000000000
000000000000000
000000000000000
000000000000000
000000000000000
000000000000000
000000000000000
000000200000000
000000000000000
000000000000000
000000000000000
000000000000000
000000000000000
000000000000000
000000000000000
-
111111111111111
100000000000001
100000000000001
100000000000001
100020000000001
100000000000001
100001111100001
100001111100001
100001111100001
100000000000001
100000000000001
100000000000001
100000000000001
100000000000001
111111111111111
-
111111111111111
100000000000001
100000000000001
100111000010001
101110000110001
100000000000001
100000020000001
100000000000001
100011000000001
100011000010001
100000000011001
100000000011001
100000000001001
100000000000001
111111111111111
-
111111111111111
100000000000001
100000000000001
101100000010001
100100000000001
100010002000001
100001000000001
100000100001001
100000000000001
100000000000001
101100001000001
100000011000001
100000011000001
100000000000001
111111111111111
-
111111111111111
100000000000001
100110111011001
100000000000001
100000000000001
100011100011001
100002000000001
100000000000001
100111100111001
100000000000001
100000000000001
101111001111001
100000000000001
100000000000001
111111111111111
-
111111111111111
100000000000001
100000200000001
100111111110001
100111111110001
100000000000001
100000000000001
100001111000001
100000000000001
100000000000001
100111111110001
100111111110001
100000000000001
100000000000001
111111111111111
-
111111111111111
100000000000001
100020000000001
100011111100001
100000000000001
100100000010001
100100000010001
100100000010001
100100000010001
100100000010001
100100000010001
100000000000001
100011111100001
100000000000001
111111111111111
-
111111111111111
100000000000001
100001000020001
100000010000001
100100000001001
100000000000001
100100000000101
100000100000001
100000000100001
100000010001001
101100000000001
100000000100001
100101000000101
100000000000001
111111111111111
-
111111111111111
100000000000001
100002000000001
100111111111001
100000000000001
100000000000001
100111111111001
100000000000001
100000000000001
100111111111001
100000000000001
100000000000001
100111111111001
100000000000001
111111111111111
-
111111111111111
100000000000001
100020000000001
101000011110001
101000000000001
101000000000001
101111111110001
101000000010001
101000000010001
100000000010001
100000000010001
100000000000001
100011110000001
100000000000001
111111111111111
